ぁ	ｧ	
ぃ	ｨ	
ぅ	ｩ	
ぇ	ｪ	
ぉ	ｫ	
っ	ｯ	
ゃ	ｬ	
ゅ	ｭ	
ょ	ｮ	
ゎ	ゎ	
あ	ｱ	
い	ｲ	
う	ｳ	
え	ｴ	
お	ｵ	
か	ｶ	
が	ｶﾞ	
き	ｷ	
ぎ	ｷﾞ	
く	ｸ	
ぐ	ｸﾞ	
け	ｹ	
げ	ｹﾞ	
こ	ｺ	
ご	ｺﾞ	
さ	ｻ	
ざ	ｻﾞ	
し	ｼ	
じ	ｼﾞ	
す	ｽ	
ず	ｽﾞ	
せ	ｾ	
ぜ	ｾﾞ	
そ	ｿ	
ぞ	ｿﾞ	
た	ﾀ	
だ	ﾀﾞ	
ち	ﾁ	
ぢ	ﾁﾞ	
つ	ﾂ	
づ	ﾂﾞ	
て	ﾃ	
で	ﾃﾞ	
と	ﾄ	
ど	ﾄﾞ	
な	ﾅ	
に	ﾆ	
ぬ	ﾇ	
ね	ﾈ	
の	ﾉ	
は	ﾊ	
ば	ﾊﾞ	
ぱ	ﾊﾟ	
ひ	ﾋ	
び	ﾋﾞ	
ぴ	ﾋﾟ	
ふ	ﾌ	
ぶ	ﾌﾞ	
ぷ	ﾌﾟ	
へ	ﾍ	
べ	ﾍﾞ	
ぺ	ﾍﾟ	
ほ	ﾎ	
ぼ	ﾎﾞ	
ぽ	ﾎﾟ	
ま	ﾏ	
み	ﾐ	
む	ﾑ	
め	ﾒ	
も	ﾓ	
や	ﾔ	
ゆ	ﾕ	
よ	ﾖ	
ら	ﾗ	
り	ﾘ	
る	ﾙ	
れ	ﾚ	
ろ	ﾛ	
わ	ﾜ	
ゐ	ｲ	
ゑ	ｴ	
を	ｦ	
ん	ﾝ	
ゔ	ｳﾞ	
ヵ	ヵ	
ヶ	ヶ	
ー	-

